11111111111111111111111111
10000000000000000000C00001
10000010000000000000000001
1001001C000000000011111001
101E1011100000000000001001
10010010000000000000C01001
10000000000C00000011111001
10P00000000000000000000001
1000000000000000C000000001
11111111111111111111111111