111z1111111111
10010000000C1
1001000000001
1111111111111

