111111111
1C0000C01
1111E1111
1P0000001
111111111