11111111111111111111
100000C000C000000001
100000001000000000C1
10000000011111000001
1P0000110E00000C0001
11111111111111111111